135,135,135,135,135,135,135,135,135,135,136,136,135,136,135,136,135,136,135,136
136,136,136,136,136,136,136,136,136,136,136,136,135,136,135,136,135,136,135,136
135,135,135,135,135,135,135,135,135,135,136,136,135,136,135,136,135,136,135,136
136,136,136,136,136,136,136,136,136,136,136,136,135,136,135,136,135,136,135,136
135,135,135,135,135,135,135,135,135,135,136,136,135,136,135,136,135,136,135,136
136,136,136,136,136,136,136,136,136,136,136,136,135,136,135,136,135,136,135,136
135,135,135,135,135,135,135,135,135,135,136,136,135,136,135,136,135,136,135,136
136,136,136,136,136,136,136,136,136,136,136,136,135,136,135,136,135,136,135,136
135,136,135,136,135,136,135,136,135,136,136,136,136,136,136,136,136,136,136,136
135,136,135,136,135,136,135,136,135,136,136,136,136,136,136,136,136,136,136,136
135,136,135,136,135,136,135,136,135,136,136,136,135,135,135,135,135,135,135,135
135,136,135,136,135,136,135,136,135,136,136,136,136,136,136,136,136,136,136,136
135,136,135,136,135,136,135,136,135,136,136,136,135,135,135,135,135,135,135,135
135,136,135,136,135,136,135,136,135,136,136,136,136,136,136,136,136,136,136,136
135,136,135,136,135,136,135,136,135,136,136,136,135,135,135,135,135,135,135,135
